aajmoen	
aajne kaarre	poikamies, vanhapoika	
aajnehke	
aakedh	
aalkoealmetje	alkoperäiskansa	
aalkoekuvsje	alkeiskurssi
aalkoeåålmege	alkuperäiskansa
aanjasoene	jalkajänne
aarege	
aarehkeaaltoe	
aarhskuvle	esikoulu
aarhte	laji
aarkebiejjie	arkipäivä
aarpije	leski
aassjoe	viha
aatedh	
aavoedidh	
abrodh	sataa
aegkie	höyhen
aejkiemierie	päivämäärä
aelhkies	yksinkertainen
aelhkieslaakan	
aelpies	halpa
aeredh	estää
aeredsbiejjie	aamupäivä
aerhkie	poronraato
aeriebielie	
aerpie	perintö
aesie	harju
aeskie	aski
aktentaale	yksikkö
alma	mies
ammesgïele	vieraskieli
appelsijnejuvse	appelsiinimehu
artihkele	artikkeli
askedibie	kuutamo
attribudte	attribuutti
baahkenidh	lämmetä
baahkestjaetsie	lämminvesi
baakoedåehkie	sanaluokka
baakoegærja	sanakirja
baakoelåhkoe	sanasto
baakoelæstoe	sanalista
baakoeraajroe	
baakoetjïerte	sanaryhmä
baakoeveeljeme	sanavalinta
baalhkalissie	palkkalisä
baanghke	pankki
baarhkoelaaje	
baarhkoevoesse	
baarhkohke	kenkä
baaroe	aalto
baartesvåhkoe	
baataridh	paeta
baataræjja	pakolainen
baegkie	
baektie	
baeniedåaktere	hammaslääkäri
baenielaejkie	hammaslanka
baenievaerhkie	hammassärky
baersieldidh	synnyttää
baetjkies	katkera
baevtieguedteme	vasikointiaika
baevtieskïeredahke	kiima-aika
bahke	mäki
balhka	nappi
baltastæjja	kummitus
barkoedåehkie	työryhmä
barkoefaaleldahke	työtarjous
barkoesijjie	työpaikka
barkoesoejkesje	työsuunnitelma
barkoestradtje	
barkoevuekie	työtapa
batjka	
batnanidh	hukkua
bealketje	peukalo
bealloeråantjoe	
beallohke	
bearadidh	
bearjedsaerede	perjantai-aamu
bearkoesnaejrie	
beeretje	nalle
beetsehke	mäntymetsä
bejhkedh	kakata
beltedh	pelotella
berkedh	kaivata
bertie	
biehtedh	pettää
biejjege	
biejjeste måbpan	
biejjhguaka	auringonpaiste
biejjiegærja	päiväkirja
biejjielaemtjie	
biekedh	
bieljehts	kuuro
bieljiegietjie
bielkie	peukalo
bihtseds	katkera
bijjiebaakoe	otsikko
birhkehtidh	
bissiebiejjie	pyhäpäivä
bodte	
boehtele	pullo
boere	
bovtsealmetje	poronomistaja
brorredh	
buaradahke	
buejtietsöötsege	talitintti
buerie aerede	hyvää aamua
buerie biejjie	hyvää päivää
buerie iehkede	hyvää iltaa
buerie jïjje	hyvää yötä
buerie-buerebe	
buerkiestimmie	selitys
buhtjedh	lypsätä
buhtjiedidh	
burhtje	purki
burredh	
bustetje	teelusikka
butnedh	
buvvedh	tappaa
buvvie	
byjrese	ympäristö
byöredh	pitää
båadtsoeh	alaston
båajhtoeh	
båatsoe	poro
båatsoeburrieskuvle	
båatsoebïenje	porokoira
båatsoedajve	poronhoitoalue
båatsoejieleme	
båatsoelaake	poronhoitolaki
båejme	piekana
båelmie	
båelmiehtidh	
båeltedh	
båervie	rasva
båetskiesoene	
bårrestovvedh	
båskoe	pensas
båssodh	puhaltaa
båårhkesjidh	
bååvteres	paksutukkainen
bæhkasidh	
bæjjese	
bæjjesvåårte	
bïegke raadtan	
bïenghke	penkki
bïerje	kallio
bïesedh	päästä
bïevnese	tieto
bïhtemoere	
bïjveles	lämmin
bööredidh	kutsua
böötedh	paikata
daablodh	pelata
daabloe	lautapeli
daabloebaakoe	pelisana
daabloehtæjja	pelaaja
daajh	
daajroe	tieto
daaktedh	
daaletje	tämänpäivänen
daamehke	
daamtaj	
daan jaepien	
daan jïjjen	
daanhtsoehtidh	tanssia
daanjehtidh	hieroa
daaresjidh	pahoinpidellä
daaroengïele	norjan kieli
daasta	tähti
daata	tieto
daatoe	päivämäärä
dabran	
daellie	
daelvie doekoe	
daelviejuhteme	
daenbien	
dagkoe	
dajve	alue
daktere	tytär
daltedidh	
daltese	
dalvedh	
damhkedh	
dan man jïjnjem	
dan mietie	
dan soe	
dangkodh	tilata
dannasinie	
darvodh	tervata
dassedh	menettää
dasselidh	menettää
deakahgierehtse	
dearkoes	hermostunut
deejedh	sijoita
deerjedh	
dej åvteste	
dejbeeli	
dejpeladtje	vanhanaikainen
dielhtie	jäätikkö
dierie	
digkie	käräjät
digkiedidh	keskustella
digkiedimmie	keskustelu
digkiedimmielahtese	
direktööre	johtaja
ditnie	tina
doedtere	tunturi
doeltehtidh	
doeltijehtedh	
dom daam	
domtese	tunne
dorjehtæjja	näyttelijä
dorjese	tuote
dotnele	
duelie vuajnah	
dulvie	tulva
dunnie bealesne	
dusnie daesnie	
duvrie	karhu
duvtedh	tukea
duvtestahke	tuki
duvvehke	kuikka
dåahka	nukke
dååsveridh	
dæjmetje giesien	
dïevedh	täytyä
dïjnehke	sokeri
dïjre	viesti
dïmpere	tukki
döörhke	kaulus
eadtjohkelaakan	
ealjoeh	laiska
eanghkoen	
easadidh	nousta
easkan	
eejhteghtjåanghkoe	vanhempainkokous
eengkele	enkeli
eksaamene	tentti
elkie	poika
faadta	polttopuu
faage	oppiaine
faageaamhtese	oppiaine
faala	valas
faaledh	tarjota
faaleldahke	tarjous
faamoeh tjöönghkedh	
faatna	väinönputki
faerhmiestidh	halata
fahkes	hereillä
feejjen	iloinen
feeledh	matkustaa
feeredh	matkustaa
fijrie	poikamies
filme	elokuva
firrelidh	ravistaa
flyjjere	
foeme	tuomi
fuakedh	
funhterdidh	miettiä
færkasidh
fïerhten biejjien	
fïerhten iehkeden	
fïerpenroehtse	rätvänä
fïrredh	ravistaa
föörhkelh	nauru
gaajhkenjevlien	limainen
gaajhtse	vuohi
gaajpeles	kömpelö
gaajsege	saniainen
gaalehtjidh	
gaallohke	
gaaloe	kylmä sää
gaaltije	lähde
gaaltijejohketje	lähdepuro
gaalve	
gaanedidh	syleillä
gaaranasse	korppi
gaaredh	
gaarkoehtidh	
gaarvanadtedh	häipyä
gaarvanidh	häipyä
gaase	hanhi
gaatske	
gaave	koukku
gaavestidh	haukkua
gaavnoes	oleva
gabnjelidh	pelotella
gadtere	
gadtjeråtjka	
gadtsese	
gaejsie	vuorenhuippu
gaekere	poronkakka
gaelmie	hauta
gaelmiesijjie	hautapaikka
gaertienadtje	torppa
gaertjies	ahdas
gaessie	pihka
gaetskedh	purra
gaetskehke	
gaevnie	lelu
gahpedh	
gajhkehtestedh	kuivata
gajpe	hattu
galhkuve	loppu
galkedh	pitää
galme	kylmä
gamte	leveä
gapta	
gaptese	
gaptjese	
garhpe	kuilu
garhtse	hihna
garkedh	
garmerdidh	pröystäillä
garmeres	ylpeä
garrelaejpie	näkkileipä
garse	vesiputous
gaskedh	salamoida
gaskesadtemegïele	kommunikointikieli
gaskeviermie	internetti | internet
geahpoe	
geajnoeraejkien	
gearkeske	kivinen
gearodh	
gebrie	
gedtie	villiporo
geellege	vaimo
geeremegåetie	vankila
geerjedh	ilo
geesjelelaakan	
geevledh	
gellene lehkesne	
gie dellie datne	
giefies	köyhä
gieltegs	jännittävä
gierehtse	pulkka
gierhkie	ahma
gieriesvaejvie	rakkaussuru
gieriesvoete	rakkaus
giesememoere	
giesemeruevtie	
giesie doekoe	
giesie-eejehtimmie	kesäloma
giesiebarkoe	kesätyö
giesien	
gievrie	
gihtjedidh	kysyä
gihtjesovvedh	
gilledh	
gillehtidh	
gilmehtahke	pakastin
giltedh	kiiltää
gipsedh	kipsata
girmedh	kehua
girtedh	
girtiesijjie	lentokenttä
girvene	halukas
gitaare	kitara
goejhke	koski
goerehtalledh	haastatella
goerehtalleme	haastattelu
goerhtele	
goerke	kurki
goetsehtidh	
goetselidh	juosta
goevte	helmikuu
goevtesmoere	
golkedahke	
golkedh	
golkehke	
gorredidh	pelastaa
govlesovvedh	kuulua
govse	lehmä
grammatihke	kielioppi
gudtsien prïhtjegen åvteste	
gudtsiestidh	kiittää
guehperenlïetse	
guektien haerien	
guelhties	kylmä
gueliejaevrie	kalajärvi
guhkiesbuejtie	
gujredh	
guktie gåarede	
gumsie	karhu
gurhkedh	kaataa
gurhkestidh	kaadella
gurhtie	kuikka
gurreme	kutominen
gurremeabpese	
gurremetråajja	
gurruve	
guvhkiehtidh	
guvhkiehtæjja	
guvviedidh	piirtää
gyhtjelasse	kysymys
gyhtsele	etana
gyvjeh	nopea
gåahta	karkki
gåaroje	ompelija
gåarome	
gåaromedeerpegh	ompelutarvikkeet
gåatomelaante	laidunalue
gåetehke	avomies | avovaimo
gåetiegïele	kotikieli
gåetiesjalja	piha
gåffoeh	höyhen
gåhtjodh	kutsua
gålkoe	marraskuu
gårroebielie	
gårroeh bielie	
gåvles	
gåvnahtalledh	
gåårestahke	ompelulanka
gåårtenje	nauha | lanka
gæjsa	
gællasjidh	maata
gælloeh	makaava
gæmhpodh	taistella
gæmhpome	taistelu
gærrodh	kirota
gïehke	vaadin
gïelebiesie	kielipesä
gïeledajve	kielialue
gïelejarnge	kieliopetus
gïelenjoelkedasse	kielisääntö
gïeleööhpehtimmie	kieliopetus
gïeltege	
gïerene	kiiruna
gïerestalledh	
gïerestidh	
gïerhgietjie	huippu
gïeriesvoelpe	ystävä
gïermesje	käärme
gïerte	
gïesedh	
gïeteråantja	johtoporo
gïethgierehtse	
gïevehpluevie	suo?
gïevehtidh	keinua
gïjre doekoe	
gïjrelaante	
gïrse	
göögkeles	upea | mainio
göökten harran	
gööles	kalaisa
haelieh	
haeliehtidh	lentää
haerrie	harjus
hajkedidh	juosta
hajkodh	heittää
heamture	tarina
heejle	kokonainen
heevehtimmie	juhlinta
hievnie	hämähäkki
hievnieviermie	hämähäkinseiti
hijven hov	
hojjedh	valita
hopsedh	haista
hujnies	surullinen
hurrehke	
hussege	vesi-itikka
håagkstaavra	onki
håhkoe	toivo
håågkedidh	kalastaa
håålesjidh	
hælloe	hylly
iehkeden	
iehtsedh	rakastaa
iehtseles	rakastettu
ierie	
ihkuve	ikuinen
ij	ei
ij åejjieh vielie guedtieh	
jaa hævvi	
jaame	kuollut
jaehkedh	uskoa
jaemedh	kuolla
jaemielidh	kuolla
jallese	
jarkedh	kääntyä
jarkelidh	kääntää
jarnge	keskus
jeahna	jättiläinen
jeanoe	joki
jearja	
jearmijes	järkevä
jearsoes	turvallinen
jeeluve	pääoma
jemhkelde	pimeys
jestiehtidh	
jiehtege	lause
jielemeguvvie	elokuva
jiesie	
jievege	matto
jihtseles	tiivis
jillieraedtie	
jimhkelidh	tuhota
jipse	kipsi
jirredeaereden	
johke	puro | joki
johkebealam	joenreuna
johkenjaelmie	joensuu
jorkesidh	muuttua
jorkestimmie	muutos
jovjeråtnoe	
juakasovvedh	jakaantua
juelkiebielie	
juelkietjengkere	jalkapallo
jueskiedahke	jääkaappi
juhteme	
julevsaemie	luulajansaamelainen
julevsaemiengïele	luulajansaamen kieli
jupmele	jumala
jurjiehtamme beapmoeh	
jurjiehtæjja	kokki
juvse	tuoremehu
jåamoe	hapro | juomu
jåaskoedehtedh	viilentää
jåerhkedh	
jånnga	pöytäveitsi
jårredh	
jåvleaske	joulukuu
jåvlejïjje	jouluyö
jåvlelaavloe	joululaulu
jåvli mænngan	
jåvli åvtelen	
jååktetje jïjjen	
jæjsodh	
jïekedh	
jïermestalledh	miettiä
jïermijes	viisas
jïjjedidh	yöpyä
jïjjesnjågloe	lehtopöllö
jïjledh	kirvellä
jïjseme	
jïlleskuvle	korkeakoulu
jöömmetje	kaksonen
kapteene	kapteeni
keebrege	korppu
klaapsaspaarra	
klaeries	kirkas
klajkesidh	
klajkodh	kiekua | kukkua
klodtje	aukko
klååmsehth	
klæhtoehtidh	leikkiä
kneekedh	jyrsiä
knugkedh	hieroa
konsulente	neuvonantaja | konsulentti
kontejnere	kontti
konvensjovne	konventio | sopimus
kraavhtse	puuro
kraejedh	röhkiä
kraejhpies	kumpuileva
kraesienjålhtja	heinäsirkka
kreadta	kahvilisäke
kreeke	eläin
kreemsedh	tarttua
kristedh	kastaa
kroenesaate	vihannes
kruepieslaejpie	tumma leipää
kråahpe	keho
kråavvoehrudtjen	
krïevve	poro
krïtnedh	murista | äristä
kuvsjeplaane	kurssisuunnitelma
kvæjta	pallas | ruijanpallas
kåale	kaali
kåarje	kori
kåvrehts	uninen
kååpe	naisten takki
laabjehtidh	
laaje	
laampe	karitsa
laanteburrie	maanviljelijä
laantemuerjie	metsämansikka
laavenjasse	tehtävä
laavkometjïehtjele	kylpyhuone
laemtjie	ohjakset
laemtjiestidh	
laessie	kuorma
lapte	vintti
lea	olla
leahkoe	poikkipuu
leaksoe	läksy
leamkedh	sulata
leamoestidh	ryöpätä
learoegærja	oppikirja
learoeplaane	oppisuunnitelma
learoesoejkesje	oppisuunnitelma
learoevierhtie	oppineuvo
learohke	oppilas
learohkedåehkie	oppilasjoukko
leatskodh	uppoa
leekedh	teurastaa
leekemebovtse	
leekemebïjle	teurastusauto
leesedh	lukita
leevege	neulanen
libnjiedidh	haista
lidtedh	metsästää
liemme	lato
lijhkiemåvhka	alushousut | pikkuhousut | pikkarit
lijhkiesjåarhtoe	aluspaita
lijhkievaarjoe	alusvaatteet
lissie	lisäys
lissiehtidh	lisätä
loehke	
loehkegierehtse	
loejhmedh	valita
loeve	silmäluomi | luomi
loeves	irtonainen
loevesmiesie	
lohkehtidh	opettaa
lopmedoenehke	lumikelkka
lopmefealloe	lumilauta
lovvehtidh	liottaa
luehkedh	
luemege	sopuli
luhkieakte	yksitoista
luhkiegaektsie	kahdeksantoista
luhkiegolme	kolmetoista
luhkiegovhte	kuusitoista
luhkiegöökte	kaksitoista
luhkienieljie	neljätoista
luhkietjïjhtje	seitsemäntoista
luhkieuktsie	yksitoista
luhkievïjhte	viisitoista
lustes	hauska
luvhtedh	täytyy
luvlene	idässä | itä
låabpoeh	hajotettu
låamma	tasku
låavtege	teltta
låemie	
låesuve	
lårhvoehbïenje	
låssas	
låvnadahke	auringonnousu
læstoe	
lïemkeds	leuto
lïene	lämmin
lïerehtidh	opettaa
lïerhkelidh	
lïhtsege	
lïhtsestidh	leikata
lööbpedh	levittää
lööneme	laina
maadthööhpehtimmie	perusopetus
maadtoe	alkuperä
maalestahke	ateria
maalle	malli
maarhte	näätä
maehtehtje	taitava
maejstedh	maistaa
maeksemekåarhte	maksukortti
man	kuinka
man båeries	
man gaavhtan	
man gellie	
man guhkiem	
man jïjnje	
man stoerre	
maskastimmien raajan	
mastedh	sekoittua
mearhka	sumu
mearoegööleme	merikalastus
measehke	
meile	sähköposti | maili
miehtjiebasse	
mieriesoejkesje	aikasuunnitelma
mietiebïegke	myötätuuli
mij dellie	
mij faatoes	
mij joem	
mij vielie	
mijjieh	
minngehke	jälkijoukko
mobïjle	kännykkä | matkapuhelin
moehtegadtje	lumikko
moeregaerie	puukulho
moeretsöölhke	tikka
moevse	lokki
mohtedidh	vertailla
mojhteladtedh	
mojhteleslaakan	
mojhtestehtedh	muistuttaa
mojjehtidh	hymyillä
mojnestimmie	arvoitus
molledh	seurustella
molsesovvedh	vaihtaa
mov luvhtie	
mubpiengïele	toinen kieli | vieraskieli
mueltie	multa
muerjie	marja
mulliedidh	
multie	multa
murhkedh	murskata
måaladidh	maalata
måara	iso luu
måarahtovvedh	suuttua
måaskedh	loukkaantua
måaskodh	loukkaantua
måedtieh såarhth	
mårhkedh	tuhoutua
måskoes	suljettu
mænngese	taakse
mïele	mieli
mïjle	miili | 10 km | kymmenen kilometriä
na	| melko
naa guhkiem	
naan aejkien	
naapere	pora
naemie	
naestie	tähti
nahkere	väsymys
najpetje	pieni veitsi
nalhke	tyyny
namhpe	poronmerkki
napkedh	kulua
nastedh	
neebne	kaima
neeledh	hävetä
nejpiensjapmere	
nieskedh	
nieskemegalte	
nieskemeruevtie	
nietsege	sääriluu
nihtedh	kieltää
njaaka	
njaalmeldh	suullinen
njaalmeldhgïele	
njaarege	
njaarke	saarento
njaavhkodh	naukua
njaelkieslaakan	
njalkedh	
njallemejuelkie	
njallesbuejtie	
njaltja	iho
njealjehts	neljännes
njelliestidh	nylkeä
njeltedh	
njevlie	lima
njilkehtidh	
njimkedahke	liima
njoere	mehukas
njoktje	maaliskuu
njorkedidh	viheltää
njovhkedidh	laulaa
njuenehke	
njålhtjodh	hypätä
njæjhkodh	itkeä
njïdtjele	
noeredaltese	yläaste
noereskuvle	yläaste
noerhte	pohjoinen
noerhtene	
noerhtesaemie	pohjoissaamelainen
noerhtesaemiengïele	pohjoissaamen kieli
novh gujht	
novh lea	
nuhtjedh	käyttää
numhtie	
nyjsene	nainen
nyöjhkemehaamoe	kieltomuoto
nåajsan	raskaana
nåajtodh	
nåakelaakan	
nåalodh	puhua
nåejtie	noita
nåekies	huono
nårroe	nyytti
nårtodh	
nåtsh	
nåå nåå	
nåå nåå dellie	
nåålesidh	
nænnoestidh	määrätä
nïhpesjidh	
nïmmehtsmoere	
nïmmerh	
nöökedh	
obrijidh	sataa
ohtsije	hakija
oktebisnie	
olle	
organisasjovne	järjestö
organiste	urkuri
orredaamehke	
orredaaroengïele	nykynorja
orreråantja	
orrijimmie	
ov nimhtie	
ovmessie	erilainen
paajsanidh	
pahke	pakata
peanna	kynä
peannagåetie	kynäkotelo
pearalaejpie	perunaleipä
pedagogihke	kasvatustiede
plaantege	sekoitus
plaerietjaeleme	lehtikirjoitus
pleaksjode	
plijrehtahke	koriste
plåahkodh	
praare deava	
programme	ohjelma
prïhtjhvoesse	kahvipussi
prïhtjhvoessetje	kahvipussi
pååjketje	pikkupoika
raadtehts	
raajedh	lähettää
raajese	lause
raajesetseegkeme	lauseoppi
raajnevaarjoe	sadevaatteet
raame	
raante	peura
raarahtalledh	neuvotella
raarhkemestuhtje	
raaste	raja
raavtedh	
raavtehtje	voimakas
raavteres	voimakas
radio	radio
raedtehke	
raejkiebaenie	reikähammas
rahka	marraskuu
rahta	kuusimetsä
rajjadidh	
rasse	
reavsa	
reehkedh	
reektedh	
reektehts	rapporti
reeredh	hallita
rehkere	höylä
rektore	rehtori
restiedidh	
rihkijahtjedh	
rijredh	ratsasta
rohtedh	
rutjkes	ruskea
ryöjrehtidh	
råakodh	haukkua
råanedh	
råase	peura
råatedh	
råateme	ilves
råavedh	
rååpsedidh	punastua
råårhkesje	kuivakuusi
ræhka	
rïeresjidh	pitää
rïesedh	koristaa
rïevtege	koppakuoriainen
rïhkedahke	kiima
rïhkede	lokakuu
rïhkijidh	
rïhpesidh	avautua
rïjtedh	laitta
röödtsedh	
rööhtse	rotta
saadtege	lähete
saadteske	hiekkaranta
saajkardahke	
saajkardidh	
saavredh	harjoitella
saavrehks	kestävä
saedtiepaehpere	hiekkapaperi
saejmie	
saelhties	suolattu
saemesth amma	
saemiedigkie	saamelaiskäräjät
saemiedigkiepresidente	saamelaispresidentti
saemiengïele	saamen kieli
saemienkultuvre	saamen kulttuuri
saemiensiebrie	saamelaisjärjestä
saemienskuvle	saamelaiskoulu
saemienööhpehtimmie	saamenopetus
saevege	lippu
saevegebiejjie	liputuspäivä
saeviehtidh	heiluttaa
sarhvegidh	
sarve	hirvi
seahkoe	sorkka
seahkoemåara	
seahkoevoeje	
seammalaakan	samanlainen
searome	poski
seeptjedh	
sermie	
sesnie	
siegkies	laiha
sieptie	
sietedh	keli
sieties	makea
sigledh	purjehtia
sihtege	ahven
sijjieh	
sijjienomme	paikannimi
sisnjelen	
sisvege	sisältö
sjaavodh	
sjeavodslaakan	
sjilkedh	sulata
sjilkehtimmie
sjoehkedidh	huokata
sjovnestidh	palvella
sjyjjedehtedh	
sjyjjehke	liukas
sjyjjesjidh	
sjåarhta	paita
sjïele	häälahja
sjïjlelaejpie	
sjöövelidh	sekoittaa
sjöövememielhkie	ternimaito
skaale	kuori
skaanjedh	kilistää
skaavhtes	
skaavtjoe	parta
skeenedh	
skeeredh	
skeerestidh	
skeerkedh	kirkastua
skierrie	vaivaiskoivu
skijre	harakka
skilledh	
skirhmedh	tuhota
skirreduarsta	kiirastorstai
skitjskiestidh	
skodth varki	
skopmehke	viita
skråavva	kaulin
skråevviestidh	
skuehtiejaepie	karkausvuosi
skuehtiejaepiebiejjie	karkauspäivä
skylledh	käydä ripillä
skylleme	rippijuhla
skåerrie	
skååffedh	hankkia
skïemmenidh	hävetä
skïemtjelasse	sairaus
skïerede	syyskuu
skïeredh	
skïeremesarva	
skïhpe	laiva
slaahpoesoene	selkäsuoni
slaarve	valhe
slaarvestidh	juorua
slaarvestimmie	juoru
slajkedh	irtoa
slearodh	heittää
sleebpedh	kaataa
sleegkedh	
sleehpeldihkie	
sleejedh	
sliehtie-elmie	räntäsää
slovves	katala
sluekieh	teurastusjätteet
slyöbpedh	välttää
slyöhpedh	välttää
slåavege	
slïehtehke	pulmunen
smaahkodh	hakata
smaarege	murre
smaarehtjïerte	murre
snarredh	
sneehpeslaakan	
snjipkedh	päästä
snjuhtjie	kärki
snovsedidh	niistää nenää
snurke	sika
snåhta	teerinaaras
snööledh	laidun
snöölhke	susi
soejkesje	suunnitelma | idea
soejkesjidh	suunnitella
soekse	toukka
soelkehtidh	lohduttaa
soen’åedtjie	
soeskedh	purra
soevestahke	savuliha
sohte	epidemia
sojjehtidh	taivuttaa
sojjehtimmie	taivutus
sommedh	kuiskata
soptsese	kertomus
soptsestimmie	lausunto
soptsestæjja	kertoja
sovhte	flunssa | nuha
spaaneserehkere	
spaenjietsåaka	
sperniedidh	
spååredh	säästää
spïele	soitin
staate	valtio
staehkie	heinäseiväs
staellie	talli
staeriedidh	oikoa | korjata
steeblege	saapas
stoenedh	
stoerredigkie	suurkäräjät
stoerredålle	suurtuli
stoerregiebnie	suurkattila
straavedh	
stratjke	ruisku
stråmhpoe	pensas
stråmhpoeraedtie	
stræjjavoesse	juuttireppu
ståante	hetki | tuokio
ståapa	tupa | talo
ståaradidh	
stïelhke	varsi
stöörelgovvedh	häiriintyä
sualadidh	varastaa
suehpedebaelie	vasikoimisaika
suehpiehtidh	vasikoida
suvhpie	haapa | metsähaapa
suvtie	raate
svaejlehke	
svirrege	päästäinen
svååredh	vastata
svæjmoedidh	pyörtyä
sygkeldidh	pyöräillä
sygkesidh	tulla vedetyksi
syhtjegh	
syjjehtimmie	taivutus
såahpodh	vasikoida
såajoe	siipi
såakelgidh	
såaltje	maine
såataskidh	
såekiegalte	koivuhalko
såeleme	
såelie	oksa
såevlie	
sårkoe	suru
såvnjodh	ravistaa
såvrodh	hapantua
sååketje	
sååketjekraesie	
sælta	silli
sïejhme	tavallinen
sïerke	paju
söökesmielhkie	
söönedh	
taale	luku
tekste	teksti
telefovne	puhelin
telefovnenummere	puhelinnumero
tjaalaldahke	kirjoitus
tjaalaldihkie	kirjoitettu
tjaalege	kirjoitus
tjaaleldahke	kirjoitus
tjaaleldhgïele	kirjakieli
tjaalesthtjomhpe	tavu
tjaalestidh	
tjaavtese	nousu
tjaelije	kirjailija
tjaevtedh	
tjahtedh	
tjaktje doekoe	
tjaktjege	
tjaktjelaante	
tjalmese	verkkomaha
tjarme	nyrkki
tjeakoes	salainen
tjeapetji	
tjeavra	saukko
tjerkie	
tjiehpies	kätevä
tjiehpieslaakan	
tjihtese	runo
tjillege	
tjimkedh	
tjimkeslaakan	
tjoejkedidh	
tjoere	kärpänen
tjoevke	valo
tjoevkedh	loistaa
tjoevtje	siika
tjohtjedh	
tjomhpe	
tjomhpetje	
tjonkedh	
tjovle	leninki | hame
tjuatsajidh	
tjuekie	
tjuetsedh	sataa lunta
tjulhte	seula
tjulhtedh	seulota
tjurrie	harjunselkä
tjåagka	haarukka
tjåagkodh	
tjåalhte	
tjåalhtetje	
tjåanghkenidh	kokoontua
tjåanghkoetjïehtjele	kokoushuone
tjåetskemes	kylmä
tjåhkome	
tjåånehtahke	
tjååtsele	sorsa
tjæjnodh	
tjïelhke	kelkka
tjïelkestidh	selittää
tjïerte	ryhmä
tjïevhtje	meriharakka
tjïrredh	nokia
tjöölle	vaaleansininen
toelhke	tulkki
tovme	tyhjä
traste	rastas
trimhkestidh	
tryöjjadidh	viihtyä
tråahpe	raput | portaat
trïengkestidh	olla renkinä
tsaepmedh	lyödä
tsagkeldhdueljie	
tsagkeme	kimpsut ja kampsut
tsegkiedeakehke	
tsiehkie	tilanne
tsietsedh	
tsietsehthmuerjie	vadelma | vattu
tsiptsedh	purista
tsoepkenidh	katketa
tsuvvedh	ravata
tsyögkesidh	
tsåaka	
tsåakodh	putoa
tsåalhkodh	
tsåapkodh	
tsåelhkielaejpie	
tsåeptseles	
tsïengele	tammikuu
tv-spïele	tv-peli
tåårske	turska
tæhtjoe	katto
tæjmosne båatam	
töölledh	kestää
ujkierdidh	ulvoa
ulmie	tavoite
unnebelåhkoegïele	vähemmistökieli
ussjedimmie	ajatus
vaajese	tarina
vaanghka	
vaanghkaklivvie	
vaanghkamåara	
vaarese	
vaarhkedh	särkiä
vaarjelidh	säilyttää
vaeriej dubpelen	
vaerieståapoe	
vaestiedasse	vastaus
valkedh	lähteä
valkedhokse	
varkedh	
veajalidh	putoa
veajedh	luistaa
vealah	makaava
vealmetje	
veanasoene	
veartene	maailma
vedtiestidh	antaa
veele	
vervies	terve
vestieslaakan	
vetneme	majava
vierhkieskaavtege	työkalupakki
vierhtie	
vierhtiedidh	arvioida
vierhtiedimmie	arviointi
vihtehks	viisas
vijrije	metsästäjä
vijsies	viisas
voehpe	appiukko
voehpealmetjh	appivanhemmat
voejedaellie	
voejedh	uida
voelege	olut
voelkehtidh	
voelpe	ystävä
voerhtje	varis
voerkedahke	
voestes gietjeste	
voestesgïele	
vokaale	vokaali
vuajnah tjaangh	
vuajnajidh	nähdä
vuaksa	härkä | sonni
vuanove	anoppi
vuarhkemesarva	
vuehtedh	
vuejemelohkehtæjja	ajo-opettaja
vuekielïhtse	
vuelie	
vuelieraedtie	alareuna
vuelkeme	matka
vuerpie	arpa
vuertieh ånnetji	
vuhtsedh	laukata
vyölkedidh	
våajodh	uppoa
våaroe	vuoro
våatjodh	
våhkoesoejkesje	viikkosuunnitelma
væjkeleslaakan	
vïehkesadtedh	
vïekesjidh	punnita
vïelletjh	veljekset
vïenes	ystävällinen
vïjve	vävy
vïrre	veri
vïssjedh	viitsiä
vïssjeleslaakan	
vïtnedh	voittaa
vöönhtse	kana
vöörhkedh	piilota
åabpedh	pelastaa
åabpetjh	siskokset
åadtjijebearkoe	
åahpanadtedh	
åarjelsaemiengïele	eteläsaamen kieli
åarjene	
åbrodh	sataa
åejjiemoere	
åejvieboelhke	pääosa
åejviegïele	pääkieli
åejvieulmie	päämäärä
åelkies bielie	
åemehke	vainaja
åemie	vainaja
åeniedidh	lyhentää
åeniedimmie	lyhenne
åeremesijjie	
åerpele	serkku
åeruve	orava
åesiestimmielæstoe	kauppalista
ålkode	
ålkoelaante	ulkomaa
ålkoeokse	ulko-ovi
ångkene	lapsi
årromesijjie	asuinpaikka
åssjalommes	ajatus
åvtebielie	etusivu
åvtese	
åvtesne	
åvtesnuelie	
åågkesjidh	haista | tuoksua
ååjmedidh	
ååjretje	
ååjsehtalledh	
åårke	harju
ööhpehtimmiedirektoraate	koulutusvirasto
öörnege	järjestys
